000000000000000000000000000000000000000000000000000000000000000000000
000000000000000000000000000000000000000000000000000000000000000000000
000000000000000000000000000000000000000000000000000000000000000000000
000000000000000000000000000000000000000000000000000000001000000000000
000000000000000000000000000000000000000000000000000000011100000000000
000000000000000100000000000000001111100000000000000000001000000000000
000000000000000111100000000000111111111200000000000000000000000000000
000000000000000111111100000011111111111120000000000000000000000000000
000000000000000111111111100111111111111112000000000000000000000000000
000000000000000111111111111111111111111112000000000000000000000000000
000000000000000111111111111111111111111112000000000000000000000000000
000000000000000000000000000011111111111110000000000000000000000000000
000000000000000000000000000001111111111000000000000000000000000000000
000000000000000000000000000000011111110000000000000000000000000000000
000000000100000000000000000000000000000000000000010000000000000000000
000000001110000000000000000000000000000000000000111000000000000000000
000000011111000000000000000000000000000000000000010000000000000000000
000000000000000000000000000000000000000000000000000000000000000000000
000000000000000000000000000000000000000000000000000000000000000000000
000000000000000000000000000000000000000000000000000000000000000000000
000000000000000000000000000000000000000000000000000000000000000000000
000000000000000000000000000000000000000000000000000000000000000000000
000000000000000000000000000000000000000000000000000000000000000000000
000000000000000000000000000000000000000000000000000000000000000000000
