000000000000000000000000000000000000000000000000000000000000000000000
000000000000000000000000000000000000000000000000000000000000000000000
000000000000000000000000000011111111111111000000000000000000000000000
000000000000000000000000000011111111111110000000000000000000000000000
000000000000000000000000000001111111111111000000000000000001110000000
000000000000000000000000000000111111111111100000000000000001110000000
000000000000000000000000000000111111111111110000000000000000100000000
000000000000000000000000000000111111111111111000000000000111111000000
000000001110000000000000000001111111111111111100000000000011110000000
000000001110000000000000000011111111111111111000000000000000000000000
000000000100000011111111100111111111111111110000000000000000000000000
000000011100000011010110101111111111111111100000000000000000000000000
000000011111000011111111100000000100000000000000010000000000000000000
000000001110000011111111111111111111111111111111100000000000000000000
000000000000000001111111111111111111111111111111000000000001110000000
000000000000000000110101101010101101010110111110000000000001110000000
000000000000000000011111111111111111111111111100000000000000100000000
000000000000000000001111111111111111111111111000000000000111100000000
000000000000000000000000000000000000000000000000000000000111111100000
000000000000000000000000000000000000000000000000000000000011111000000
000000000000000000000000000000000000000000000000000000000000000000000
000000000000000000000000000000000000000000000000000000000000000000000
000000000000000000000000000000000000000000000000000000000000000000000
000000000000000000000000000000000000000000000000000000000000000000000
