000000000000000000000000000000000000000000000000000000000000000000000
000000000000000000000000000000000000000000000000000000000000000000000
000000000000000000000000000000000000000000000000000000000000000000000
000000000000000000000000000000000200000000000000000000000000000000000
000000000000000000000000000000002220000000000000000000000000000000000
000000000000000000000000000000011111000000000000000000000000000000000
000000000000000000000000000000111111100000000000000000000000000000000
000000000000000000000000000001111111110000000000000000000000000000000
000000000000000000000000000011111111111000000000000000000000000000000
000000000000000000000000000111111111111100000000000000000000000000000
000000000000000000000000001111111111111110000000000000000002000000000
000000000000000000000000011111111111111111000000000000000022200000000
000000000000000000000000000000000000000000000000000000000111110000000
000000000020000000000000000000000000000000000000000000001111111000000
000000000111000000000000000000000000000200000000000000011111111100000
000000001111100000000000000000000000000200000000000000111111111110000
000000011111110000000002000000000000000000000000000001111111111111000
000000111111111000000002000000000000000000000002000011111111111111100
000000000000000000000000000000000000000000000002000000000000000000000
000000000000000000000000000000000000000000000000000000000000000000000
000000000000000000000000000000000000000000000000000000000000000000000
000000000000000000000000000000000000000000000000000000000000000000000
000000000000000000000000000000000000000000000000000000000000000000000
000000000000000000000000000000000000000000000000000000000000000000000
