000000000000000000000000000000000000000000000000000000000000000000000
000000000000000000000000000000000000000000000000000000000111000000000
000000000001100000000000000000000000000000000000000000111111111000000
000000000011110000000000000000000000000000000000000000000111000000000
000000000001100000000000000000000000000000000000000000000000000000000
000000000000000000000000000000000000000000000000000000000000000000000
000000000000000000000000000000000000000000011111111111111111000000000
000000000000000000001111111110000000000001111111111111111111100000000
000000000000000000001111111111000000000000000000022000000000000000000
000000000000000000000000000200000000000000000000220000000000000000000
000000000000000000000000000020000000000000000002200000000000000000000
000000000000000000000000000002000000000000000022000000000000000000000
000000000000000000000000000111111111111111111120000000000000000000000
000000000000000000000000000111111111111111111100000000000000000000000
000000000000110000000000000111111000000000000000000000000000000000000
000000000001111000000000000000000000000000000000000000000000000000000
000000000000110000000000000000000000000000000000000000010000000000000
000000000000000000000000000000000000000000000000000000111000000000000
000000000000000000000000000000000000000000000000000000010000000000000
000000000000000000000000000000000000000000000000000000000000000000000
000000000000000000000000000000000000000000000000000000000000000000000
000000000000000000000000000000000000000000000000000000000000000000000
000000000000000000000000000000000000000000000000000000000000000000000
000000000000000000000000000000000000000000000000000000000000000000000
