000000000000000000000000000000000000000000000000000000000000000000000
000000000000000000000000000000000000000000000000000000000000000000000
000000000000000000000000000000000000000000000000000000000000000000000
000000000000000000000000000000000000000000000000000000000000000000000
000000111200000000000000000000000000000000000000000000000000000000000
000000111200000000000000000000000000000000000000000000000000000000000
000000111200000000000000000000000000000000000000000000000000000000000
000000111200000000000000000000000000000000000000000000000000000000000
000000111200000000000000000000000000000000000000000000021110000000000
000000111200000000000000000000111000000000000000000000021110000000000
000000111200000000000000000001111100000000000000000000021110000000000
000000111200000000000000000001111100000000000000000000021110000000000
000000111200000000000000000000111000000000000000000000021110000000000
000000111200000000000000000000000000000000000000000000021110000000000
000000111200000000000000000000000000000000000000000000021110000000000
000000000000000000000000000000000000000000000000000000021110000000000
000000000000000000000000000000000000000000000000000000021110000000000
000000000000000000000000000000000000000000000000000000021110000000000
000000000000000000000000000000000000000000000000000000021110000000000
000000000000000000000000000000000000000000000000000000000000000000000
000000000000000000000000000000000000000000000000000000000000000000000
000000000000000000000000000000000000000000000000000000000000000000000
000000000000000000000000000000000000000000000000000000000000000000000
000000000000000000000000000000000000000000000000000000000000000000000
