000000000000000000000000000000000000000000000000000000000000000000000
000000000000000000000000000000000000000000000000000000000000000000000
000000000000000000000000000000000000000000000000000000000000000000000
000000000000000000000000000000000000000000000000000000000000000000000
000000000000000000000000000000000000011111111111000000000000000000000
000000000000000000000000000000000000111111111111100000000000000000000
000000000000000000000000000000000000111111211111100000000000000000000
000000000000000000000000000000000000111111211111100000000000000000000
000000000000000000000000000000000000111111211111100000000000000000000
000000000000000000000100000000000000111111211111100000000000000000000
000000000000000000001110000000000000111111211111100000000000000000000
000000000000000000000111000000000000111111211111100000000000000000000
000000000000000000000011100000000000111111211111100000000000000000000
000000000000000000000001110000000000111111111111100000000000000000000
000000000000000000000000111000000000011111111111000000000000000000000
000000000000000000000000011112000000000000000000000000000000000000000
000000000000000000000000002220000000000000000000000000000000000000000
000000000000000000000000020022000000000000000000000000000000000000000
000000000000000000000000000000000000000000000000000000000000000000000
000000000000000000000000000000000000000000000000000000000000000000000
000000000000000000000000000000000000000000000000000000000000000000000
000000000000000000000000000000000000000000000000000000000000000000000
000000000000000000000000000000000000000000000000000000000000000000000
000000000000000000000000000000000000000000000000000000000000000000000
